################################
#     #     ##              #  #
#  #     #  ## ##     #  #  #  #
#  ####  #  ##### #####  #  #  #
#  #     #        ##     #  #  #
####  ##########  ########  #  #
#           ##    ##     #     #
#        #            #  #     #
####  #  ##############  #  ####
#     #  #               #     #
#  #######  #################  #
###   #   ############    ###  #
#  #  #        ##              #
#  #  ######## ## ##  ##########
#     #     ## ## ##  #        #
#        #  ##   S ##          #
################################
